# #############
#             #
#####  ########
#        #    #
#  #######    #
#             0
###############